# Conversational Latin Glossary Ch 1/10
bene se habere; valeo -ere -ui=be fine
recte valere=to be very well
vale (pl: valete); bene vale (pl: bene valete)=goodbye
quid agis?; ut vales?=how are you?
bene mihi est=I am fine
trado -dere -didi -ditus=introduce to (+dat)
convenio -venire -veni -ventus=meet
nomen -inis=name
non male=not bad
mihi pergratum est te convenire=pleased to meet you!
gratias!=thanks!
gratias maximas!=thanks a lot!
sescentas gratias=thanks a million!
unde es?=Where are you from?
unde venis?=Where are you coming from?
Qui vales?=How are you?
Recte; belle=fine
perbelle; belissime=very well
me bene habeo=I'm fine
haud male quidem valeo=I'm doing quite well
ut te habes?=how are you?
varie=so-so
mediocriter quidem valeo=fairly well
haud male=not bad
non optime sane=Not too well
ut soleo=as usual
plane infeliciter=lousy
satin salve?=Everything O.K.?
omnia sunt pulchre; omnia sunt feliciter; omnia sunt festiviter=Everything is O.K.
Salve. Valuistine?=Hello. How've you been?
Probe! Euge!=Fine! Great!
Em, vivo.=Well, i'm still alive
salve=hello
salve et tu=same to you
Salve. Te convenisse volup est.=Hello. Pleasure to meet you.
Salve. Mihi quidem volup est.=Hello. The pleasure is mine.
Quo pacto res se tibi habent? Rectene sunt omnia?=How are things with you? Everything all right?
In mediocri statu=In fair shape
in optimo statu=In great shape
laetus (-a) istud audio; haud invitus (-a) audio=Glad to hear that
Est mihi istud auditu perquam iucundum=I'm delighted to hear that.
Gaudeo tua causa=I'm glad for you
Audire istud ex animo gaudeo=I'm sincerely glad to hear that
Laus superis=Thank heavens!
Nunc vale=goodbye for now
di te ament=God bless you
te cura=Take care (of yourself)
oriosus (-a) esto=take it easy
valeas beneque tibi sunt=goodbye and good luck
# Conversational Latin Glossary Ch 1/10
filia -ae adoptiva=adoptive daughter
filius -i adoptivus=adoptive son
matertera -ae=aunt (mother's side)
amita -ae=aunt (father's side)
infans -antis=baby
frater -tris=brother
levir -viri=brother-in-law
liberi -orum=children
consobrina -ae; consobrinus -i=cousin (sister's daughter)
patruelis -is=cousin (brother's child)
tata -ae=dad, daddy
nurus -us=daughter-in-law
familia -ae=family
stirps -is=family tree
pater -tris=father
socer -eri=father-in-law
paterfamilias=father of the family
atavi -orum=forefathers
neptis -is=granddaughter
tata -ae=granddad
avus -i=grandfather
mamma -ae=grandma
avia -ae=grandmother
nepos -otis=grandson
amita -ae magna; matertera -ae magna=great aunt (father's side; mother's side)
proavus -i=great-grandfather
proavia -ae=great-grandmother
patruus -i; avunculus -i=great-uncle (father's side; mother's side)
maritus -i=husband
affinis -is=in-law
fraterculus -i=little brother
sororcula -ae=little sister
mamma -ae=mom (mum)
mater -tris=mother
socrus -us=mother-in-law
filius sororis; filius fratris=nephew
filia sororis; filia fratris=niece
parens -entis=parent
cognatus -i; cognata -ae=relative
glos gloris=sister-in-law (sister of husband)
uxor -oris fratris=sister-in-law (wife of brother)
gener generi=son-in-law
coniunx coniugis=spouse
privigna -ae=stepdaughter
vitricus -i=stepfather
noverca -ae=stepmother
privignus -i=stepson
avunculus -i=uncle (mother's brother)
patruus -us=uncle (father's brother)
uxor -oris=wife
filiola -ae=young daughter
filiolus -i=young son
# Conversational Latin Glossary Ch 2/10
imminuo -ere -ui imminutus=abbreviate
nota -ae compendiaria=abbreviation
facultas -atis=ability [to read and write: legendi scribendique facultas; natural ability: ingenium -i]
absens, -entis=absent [to be absent: absum abesse abfui afuturus]
absens ansentis=absentee
academia -ae=academy
adicio -ere adieci adiectus=add
clare=aloud
responsum -i=answer [to give an answer to someone: alicui responsum reddo -dere -didi -ditus]
respondeo -dere -di -sum=to answer (in both speaking and writing: with dat of person and ad + acc of the thing)
interrogatum respondere=to answer a question (in complete sentences: totis sententis respondere)
rogare; (for info.) quaero; (about) de aliquo rogare; (a few questions) pauca quaerere; (s.o. s.th.) aliquem aliquid rogare; (s.o for s.th.) ab aliquo aliquid rogare=to ask
docentum interrogare=to ask the teacher a question
assignare=assign
pensum -i; praescriptum -i=assignment
audivisificum subsidium=audiovisual aid
stilus sphaeratus=ballpoint pen
elementa -orum=basics
latrina -ae; licetne mihi in latrinam ire?=bathroom (toilet); may I go to the bathroom?
tabula -ae atra=blackboard
liber -bri=book
capsula -ae scholaris=book bag
luculentus -a -um=bright (smart)
bombilatrum -i=buzzer
refectorium -i=cafeteria
machinula -ae calculatoria=calculator
nomina citare=call roll
littera -ae maiuscula=capital letter
exemplum -i transcusum, antigraphum -i=carbon copy
creata -ae=chalk
caput -itis=chapter
chemice -es=chemistry
classis -is=class
conclave -is scholare=classroom
collegium -i=college
scriptura -ae, compositio -onis=composition
exemplum -i=copy
exscribo -ere exscripsi=to copy [from: x + abl; cheating: clandestino]
rectus -a -um=correct (opp: pravus) [free from faults: emendatus; in the sense of "corrected": correctus]
emendare; corrigo -ere correxi correctus=to correct
correctio -onis, emandatio -onis=correction
recte, emendate=correctly
ambulacrum -i, andron -onis=corridoor
feriatus dies=day off (from school: ab schola)
tractare=deal with
decanus -i, decana, -ae=dean
mensa -ae scriptoria=desk
dictionarium -i, lexicon -i=dictionary
disputare de (+abl)=discuss
disputatio -onis=discussion
ianua -ae=door
studium -i, vis=drive, enthusiasm
instituo -uere -ui -utus=educate
institutio -onis=education
litterarius ludus=elementary school
erado -ere erasi erasus=erase
detersorium -i; gummis -is=eraser (blackboard; pencil)
lituria -ae=erasure
mendum -i, vitium -i=error (in writing)
libellus -i=essay
examinatio -onis=examination
examinare=examine
exercitium -i; exercitatio -onis=exercise (written; practice)
explanare; explicare=explain
exprimo -ere expressi expressus=express
magisterium -i=faculty
cado -ere cecidi casurs (in probatione)=flunk (a test)
figura -ae=form (grammatical)
tiro -onis=freshman
prior pars scholae=front of the room
teneo -ere -ui tentus=get (understand)
globus terrarum=globe
gradus -us=grade
nota -ae=score, grade
gradus suscipio=graduate
consiliator -oris/consiliatrix -icis scholastica=guidance counselor
trado -dere -didi -ditus=hand in, submit
chirographum -i=handwriting
index capitis=heading
schola superior=high school
historia -ae=history
conclave scholare proprium=home room
pensum (praescriptum) domesticum=homework (written)
# Conversational Latin Glossary Ch 3/10
analphabetus -a -um=illiterate
proficio -ere profeci profectum=improve
profectus -us=improvement
atramentum -i=ink
instruo -ere instruxi instructus=instruct
praecepta -orum=instructions
praeceptor -oris (-rix -ricis)=instructor
annotare=jot down
clavis -is=key
scio/nescio=know/not know
Latine=Latin (to know, read, teach, speak, understand, write)
disco -ere didici=learn [by heart: ediscere]
discens discentis=learner
lectorium -i=lectern
versus -us=line (of prose or poetry)
tabula geographica=map
manuscriptum -i=manuscript
significo -are=mean
numerus -i=metre
mendum -i=mistake
commentarios conficio=to take notes
pugillares -um=note pad
libellus -i=note book
pagina (in ima/summa)=page (at the bottom/top)
charta -ae=paper
fibicula chartarum=paper clip
paragraphus -i=paragraph
probatoinem sustineo=to pass a test
locus -i=passage (in a test)
penna -ae; calamus -i scriptorius=pen
graphium -i=pencil
spatium -i=period (class period)
podium -i; pulpitum -i=podium
poema -atis=poem
indicare=point out
folium murale=poster
parare (praeparare)=prepare (in advance)
adsum adesse adfui adfuturus=to be present
rector -oris/ rectrix -tricis=principal (ludi or scholae)
ad superiorem classem promoveo=to promote
pronuntiare=pronounce
prosa -ae=prose
discipulus -i (-a -ae)=pupil
rogatum; interrogatuml quaestio=question
signum interrogationis=question mark
quaestiuncula -ae=quiz
pausa -ae; lectio -onis=reading
pausa -ae=recess
recitatio -onis=recitation
repeto=repeat
investigatio -onis=research
locus secretus (forica)=rest room (public)
retractatio -onis=review
regula -ae=ruler
scando -ere -i scansus=scan (poetry)
instrumentum scholare=school supplies
exarare, conscribillare=scribble
subsellium -i=seat
schida -ae=sheet
silentium -i=silence
imago photographica translucida=slide
segnis -is -e=slow to learn
littera minuscula=small letter
orthographia -ae=spelling
scribo -ere scripsi scriptum=spell
uncinulus (metallicus)=staple
consuo -ere -i -utus=to staple
uncinatorium; consutorium chartarum=stapler
studens -entis=student
studia -orum=studies
nova verba offendo=stumble over new words
# Conversational Latin Glossary Ch 4/10
disciplina -ae=subject
argumentum -i=topic
materia -ae=subject matter
detraho -ere detraxi detractus=subtract
index capitum=table of contents
excipio=take down (notes, lecture)
ingenium -i=talent
ingeniosus -a-um=talented
doceo=teach (w/ double acc)
magister -tri, magistra -ae=teacher
magistra adiutor=teaching assistant
docendi ratio=teaching method
probatio -onis=test
liber scholaris; ars artis=text book
tractatus -us=essay theme
(con)verto; transfero=translate [from Latin to English: ex Latino in Anglicum]
translata -orum=a translation
conversio -onis=the act of translation
pagina pellucida=transparency
domesticus praeceptor=tutor
machinula scriptoria scribo; dactylographare=to type
feriatus -a -um esse=be on vacation
vocabula -orum=vocabulary
tabula alba=white board
fenestra -ae=window
# Conversational Latin Glossary Ch 5/10
responde mihi; responde ad meum interrogatum=answer me; answer my question
veni temperi, quaeso=be on time, please
tace; silentium tene=be quiet
claude ianuam=close the door
collige chartas=collect the papers
veni huc=come here
intra=come in
agedum, tempta meminisse=come on, try to remember
perge...=continue...
desine; desiste=cut it out
omitte garrulitatem/strepitum/nugas, quaeso=cut out the chatter/noise/nonsense, please
noli exscribere ex proximo=don't cheat
nolite oblivisci perficere pensum vestrum=don't forget to do your homework
noli interpellare=don't interrupt
noli ridere eum/eam=don't laugh at him/her
noli loqui Anglice=don't speak english
noli eum/eam taxare=don't tease him/her
explica hanc constructionem=explain this construction
fac agmen unicum (duplex)=form a single (double) line
librum in manum cape; librum prome=get you your book
perge=go on
accede ad tabulam atram=go to the blackboard
librum cedo (cette)=hand me the book
chartas redde/trade=hand in the papers
distribue/prompta chartas=hand out the papers
matura=hurry up
paucis te volo post classem=I want a word with you after class
parce, quaeso=knock it off, please
audi diligenter=listen carefully
me ausculta=listen to me
converte oculos in me=look at me
id inquire in dictionario=look it up in the dictionary
remitte vocem=lower your voice
in pauca confer=make it brief
sine=never mind
aperi librum ad paginam...=open your books to page...
delinea fabulam (tractatum)=outline the story (essay)
circumfer=pass around
chartas trade ad frontem=pass the papers to the front
attende (dicta mea)=pay attention (to what I'm saying)
sepone librum=put your book away
attolle manum=raise your hand
lege sententiam proximam=read the next sentence [aloud: recita]
lege clare (lentius, celerius, clarius, flexa voce)=read aloud (slower, faster, louder, with inflexion of the voice)
eisdem verbis mihi redde=repeat after me
repete locum=repeat the passage
repete quid modo dixeris=repeat what you just said
pronomina retractemus=let's review the pronouns
ostende mihi pensum=show me your homework
silentium, quaeso!=silence, please!
conside=sit down
recte sede=sit up straight
loquere lente=speak slowly
eloquere=speak up
desine argumentari rixari=stop arguing
surge=stand up
desine scribere=stop writing
enota=take notes
in manus sume=take up
revertite ad subsellia=take your seats
converte hanc sententiam ex Latino in Anglicam=translate this sentence from Latin to English
turn around=te verte
evolve librum ad paginam (CCCXCIV)=turn to page (394)
utere dictionario=use your dictionary
eho, non tam cito!=whoa! not so fast!
sententias perscribe=write out the sentences
scribe id in tabula atra=write that on the board
# Conversational Latin Glossary Ch 6/10
responsarum -i=answering machine
vigilare=to be awake
aqualis -is=basin
ientaculum -i=breakfast
dentes purgare=brush the teeth
telephonulum portabile=mobile phone
purgare, mundare=to clean
pecto, -ere pexi pectus=to comb
pecten -inis=comb
crispare=to curl
calamistrum -i=curler
cenare=dine
patina -ae=dish, plate
aquam haurio -ire hausi haustus=draw water
supellectilem detergeo=dust the furniture
edo esse edi esus=to eat
impleo=to fill
pavimentum -i=floor
surgo -ere surrexi surrectum=get up
dormitum/cubitum eo=go to bed
obsonare=go shopping
vestimenta premo=iron clothes
comam in gradus frango=layer the hair
lectum sterno=make the bed
speculum -i=mirror
gramen reseco=mox the lawn
brevis somnus=nap
calceos polio=polish shoes
vasa -orum=pots and pans
induo -ere -i -utus=put on (clothes)
cibaria (vascula) in mensam appono=set the table
merenda -ae=snack
sapo -onis=soap
detraho; exuo=take off
telephonice=by telephone
cum aliquo telephonice colloquor=to speak with s.o. on the telephone
per telephonum vocare=to call
televisiorium -i=television
ordinare=to tidy up
peniculus -i dentarius=toothbrush
pasta -ae dentaria=toothpaste
pulveris hauritorio purgeare=to vacuum
pulveris hauritorium=vacuum cleaner
excitare e somno; expergiscor=wake up
lavo=to wash
flores adaquare=to water the flowers
# Conversational Latin Glossary Ch 7/10
athleta -ae (m) athletria -ae (f)=athlete
athleticus -a -u=athletic
athletica -ae=athletics
pila -ae; follis -is=ball
campus lusorius=ball field
lusus pilae=ball game
scamnum -i=bench (wooden seat)
copiae susidiariae=bench (players)
scamnum relegare=to bench a player
fori -orum=bleachers
obsto; obsisto; obstruo=block
exercitator -toris=coach
contendo=compete against
contentio -onis=competition
competitor -oris (trix -tricis)=competitor
apparatus -us; instrumentum -i=equipment
fautor -oris (trix -tricis)=fan
offensa -ae=foul
ludus, lusus, certamen=game
prior pars certaminis, altera pars certaminis=first half, second half
dimidium tempus=half-time
ludo superari=lose a game
turma victa=losing team
rete -is=net
seorsum esse; stare=be offside
adversarius -i=opponent
additicium tempus=overtime
primarius, secundarius, tertius=first place, second place, third place
lusor -oris, lustrix -icis=player
quo loco ludis?=what position do you play?
arbiter -tri (tra -trae)=referee
puntum -i=point [score a point: punctum fero]
summa punctorum ictuum=score
status finalis=final score
rationem punctorem notare=keep score
tabula punctorum=scoreboard
disportus -us=sport
camisia campestris=sport shirt
vestis campestris=sportswear
turma -ae=squad, team
stadium -i=stadium
fori -orum=grandstands
succedaneus -i, suppositicius -i=sub, substitute
aliquem a campo relegare=throw s.o. out of the game
sibilus -i=whistle [blow the whistle: sibilum emitto]
victoria -ae=win
turma victrix=winning team
praevalentia punctorum; praevaleo per puncta=win on points
# Conversational Latin Glossary Ch 8/10
sagittatio -onis: sagitta, arcus, ferio -ire, medius scopus, scopus=archery: arrow, bow, hit, bullseye, target
ludus pilae pinnatae: rete, pilae rete perstingens, reticulum=badminton: net, net ball, racket
corbifollis=basketball
pugilatus -us=boxing
conorum ludus, coniludium=bowling
disci iactus=discus
piscatus -us=fishing
pedifollium -i, pediludium, pedifollis=football
pilamalleus -i=golf
gymnastica, -ae=gymnastics
saltus in altum=high jump
ludus hocceius, alsulegia=hockey
venatio -onis, venatura -ae=hunting
luctatio -onis Iudoica=Judo
luctatio caratica=karate
patinatio=ice-skating
lacrossensis=lacrosse
saltus in longem=long jump
ascensio montium=mountain climbing
pentathlum -i=pentathlon
mensalis pilae ludus=ping-pong
saltus perticarius=pole vault
alsulegia equestris=polo
patinatio rotalis=rollerskating
remigatio=rowing
harpastum -i=rugby
velificatio=sailing
nartatio=skiing
pedifollium -i=soccer
tabula fluctivaga per summas undas prolabor=surf
natatio=swimming
teniludium, tenisia=tennis
cursura=track
follis volatilis=volleyball
per summas undas nartatio=water-skiing
sublatio libramentorum=weight-lifting
luctatio=wrestling
# Conversational Latin Glossary Ch 9/10
tessera aditialis=admission ticket
amplificatrum -i=amplifier
horti publici oblectarii=amusement park
symphonia -ae=band
photomachina; machinula photographica=camera
chartula lusoria=card [club: crux; diamond: ruta; heart: cor; spade: pala]
spectaculum animatum=cartoon
latrunculus; latrunculorum ludus=checker; checkers (game)
ludus scacorum; scaciludium=chess
pensum -i=chore
compactus discus=CD
discophonium -i=CD player
comoedia -ae=comedy
concentus -us=concert
saltatio -onis=dance
saltare=to dance
documentarium -i=documentary
pellicula, taeniola=film
tempus liberum=free time
alea ludo=gamble
sclopetum -i=gun
per lusum latitare et quaeritare=play hide and seek
feriae -arum=holidays
bibliotheca -ae=library
monopolium -i=monopoly
navicula automataria=motor boat
cinematographicus -a -um=movie
pellicula cinematographica=movie
imagines moventes=movies
musica -ae=music
melodramatium -i=musical
discotheca -ae=nightclub
melodrama -atis=opera
clavicordium -i=piano
calcei gymnici=sneakers, joggers, runners
lusus magnetoscopicus=video game
deambulare=go for a walk
hebdomas -adis, septimana -ae=week
dies profestus=weekday
finis hebdomadis=weekend
# Conversational Latin Glossary Ch 10/10
talus -i=ankle
appendix -icis=appendix
bracchium -i=arm
lacertus -i=upper arm
arteria -ae=artery
tergum -i=back
posticum -i=backside
barba -ae=beard
alvus -i=belly
umbilicus -i=belly button
bilis -is=bile
vesica -ae=bladder
sanguis -inis=blood [outside the body: cruor -oris]
os, ossis=bone
sinus -us=bosom
alvus -i=bowels
cerebrum -i=brain
pectus -oris=chest
mamma -ae, mammilla -ae=breast
nates -ium=buttocks
sura -ae=calf
cartilago -inis=cartilage
gena -ae=cheek
mentum -i=chin
colon -i=colon
cirrus -i, cincinnulus -i=curl
cirratus -a -um=curly
praecordia -orum=diaphragm
auris -is=ear [outer: auricula -ae]
cubitum -i, ulna -ae=armpit
gula -ae=esophagus
oculus -i=eye
orbis oculi=eyeball
supercilium -i=eyebrow
cilium -i=eyelashes
palpebra=eyelid
facies -ei=face
digitus -i=finger
unguis -is=fingernail
pugnus -i=fist
caro -onis=flesh
pes, pedis=foot
frons, frontis=forehead
genitalia -ium=genitals [female: muliebria; male: virilia]
inguen -inis=groin
gingiva -ae=gum
capillus, crinis=hair
poples -itis=hamstring
manus -us=hand
caput -itis=head [back: occipitium; top: vertex]
auditus -us=hearing
cor cordis=heart
calx -cis=heel
coxa -ae, coxendix -icis=hip
intestina -orum=intestines
maxilla -ae=jaw
articulus -i=joint
renes -ium=kidneys
genus -us=knee
patella -ae=kneecap
articulus digiti=knuckle
gremium -i=lap
crus cruris=leg
ligamen inis=ligament
labrum -i=lip [lower: inferius; upper: superius]
iecur -oris=liver
pulmo -onis=lung
medulla -ae=marrow
os oris=mouth
musculus -i=muscle
subium -i=mustache
mucus -i=mucus
unguis -is=nail [to cut the nails: ungues reseco]
umbilicus -i=navel
collum -i, cervix -icis=neck
papilla -ae=nipple
nasus -i=nose
nares -ium=nostrils
viscus -eris=organ
palatum -i=palate
pancreas -atis=pancreas
pelvis -is=pelvis
penis -is=penis
pituita -ae=phlegm
pilula -ae=pill
pupilla -ae=pupil
anus -i=rectum
costa -ae=rib
saliva -ae=saliva
tibia -ae=shinbone
humerus -i=shoulder
scapula -ae=shoulder blade
latus -eris, ilia -orum=side
visus -us=sight
calvaria -ae=skull
odoratus -us=smell
solum, planta -ae=sole
spina -ae=spine
sputum -i=spit
stomachus -i, venter -tris=stomach
sudor -oris=sweat
gustatus -us=taste
lacrima -ae=tear
tempus -oris=temple
tendo -inis=tendon
testiculus -i=testicle
femur -oris=thigh
pollex -icis=thumb
fauces -ium=throat
digitus -i pedis=toe
lingua -ae=tongue
tonsillae -arum=tonsils
dens dentis=tooth
tactus -us=touch
vagina -ae=vagina
vena -ae=vein
vertebra -ae=vertebra
arteria -ae=windpipe
uterus -i=womb
media pars corporis=waist
primoris manus=wrist
carpus -i=wrist bone
# Conversational Latin Glossary Ch 11/10
dolor -oris=ache
dolens -entis=aching
acne -es=acne
acutus -a -um=acute (illness)
adrenalinum -i=adrenaline
agilis -is -e=agile
malum -i=ailment
appetentia -ae=appetite [lack of: inedia -ae]
adhibeo=apply (a remedy)
arthritis -idis=arthritis
foetor -oris=bad breath
calvus -i=bald
fascia -ae=bandage
ligare=to bandage
foveo -ere fovi=to bathe (a sore limb)
lecto teneor=to be confined to bed
lividus -a -um=black and blue
pressio sanguinis=blood pressure
oculi eius sanguine suffuci sunt=he has bloodshot eyes
furunculus -i=boil
valgus -a -um=bowlegged
spirare=breathe
contusio -onis=bruise
se bene operio=bundle up
cancer -cri=cancer
capsula -ae=capsule
stasis cardiaca=cardiac arrest
carcinoma -atis=carcinoma
catarractae -arum=catarracacts
diuturnus -a -um=chronic
gravedo -inis=cold, flu
color -oris=complexion
contraho -ere contraxi contractus=contract
convalesco -ere=convalesce
tussio -ire=cough
convulsio -onis=cramp
diabetes mellitus=biabetes
victus ratio=diet
concoquo=digest
morbus -i=disease
medicus/medica=doctor
portio -onis=dose
medicamentum -i, medicamen -inis=drug
medicamentum psychotropicum=hallucinogen
peditum -i=fart
pedo -ere pepedi=to fart
obesus -a -um=fat [opp: gracilis -is -e]
fatigatio -onis=fatigue
febris -is=fever
fractura -ae=fracture
germen -inis=germ
glaucoma -atis=glaucoma
slavus et validus=hale and hardy
afficior affici affectus=have/suffer from
alimentum salubre=health food
sanus -a -um=healthy
impetus cardiacus=heart attack
defectio cardiaca=heart failure
hernia -ae=hernia
heroinum -i=heroin
hypertonia -ae=high blood pressure
raucus -a -um=hoarse
hormonum -i=hormone
valetudinarium -i=hospital
hygienie -es=hygiene
cruditas -atis=indigestion
inflammatio -onis=inflammation
# Conversational Latin Glossary Ch 12/10
calculi renales=kidney stones
tolutim cursitare=jog
linimentum -i=lotion
tuberculum -i=lump
medicamentum -i=medication
medicina -ae=medicine
collutorium -i=mouthwash
parotitis -idis=mumps
musculum distorqueo=pull a muscle
musculis nimis constrictus=musclebound
musculosus -a -um=muscular
myopia ae=nearsightedness
nervus -i=nerve
nosocoma -ae=nurse
gerontocomium -i=nursing home
obesitas -atis=obesity
pustula -ae=pimple
recipio valetudinem bonam=recover
remedium -i=remedy for (+gen)
distillationes -um=runny nose
tremor -oris=shiver
anhelatio -onis=shortness of breath
identidem resideo=to do situps
cutis -is=skin [pale: pallida; dry: arida; sot: mollis; tough: dura; wrinkled: rugosus]
macilentus -a -um=skinny
gracilis -is -e=slim
variolae -arum=smallpox
sternumentum -i=sneezing
luxatura -ae=sprain
apoplexia -ae=stroke
adustus color=sun tan
chirurgus -i=surgeon
se attollo=swell [opp: se summittere]
tumidus -a -um=swollen
signum -i=symptom
in deterius inclinari=turn for the worse
virus -i=virus
# Conversational Latin Glossary Ch 13/10
alcohol -is=alcohol
alcoholicus -a -um=alcoholic
amygdalum -i=almond
gustatio -onis=appetiser
malum -i=apple
crustum ex malis=apple pie
armeniacum -i=apricot
lardum -i=bacon
pistor -oris=baker
pistrina -ae=bakery
ariena -ae=banana
faba -ae=bean
bubula -ae=beef
cervisia -ae=beer
bacca -ae=berry
libum natale=birthday cake
vaccinium -i=blueberry
elixus -a -um=boiled
temetum -i=booze
panis -is=bread
collyris -idis=bun
lanius -i=butcher
butyrum -i=butter
brassica -ae=cabbage
placenta -ae=cake
cuppedia -ae=candy
carota -ae=carrot
cerealia -ae=cereal
savillum -i=cheesecake
cerasum -i=cherry
gallinacea -ae=chicken
socolata -ae=chocolate
mundare mensam=clear the table
propoma -atis=cocktail
caffea -ae=coffee
crustulum -i=cookie
extraculum -i=corkscrew
maizium -i=corn
cremum -i, flos lactis=cream
bellaria=dessert
embamma -atis=dressing
potio -onis=drink
edo esse edi esu=eat
ovum -i=egg [fried: frictum; hard-boiled: durum; soft-boiled: apalum; scrambled: permixtum]
piscatus -us=fish
furcilla -ae, fuscinula -ae=fork
poma terrestria fricta=French fries
recens -entis=fresh
poma -orum=fruit
congelatus -a -um=frozen
frigo -ere frixi frictus=fry
sartago -inis=frying pan
alium -i=garlic
uva -ae=grape
craticula -ae=grill
perna -ae=ham
bubula concisa=hamburger
mel mellis=honey
congelidum cremum=ice cream
quilon -i=jelly
succus -i=juice
phaselus -i=kidney bean
ketsupum -i=ketchup
trulla -ae=ladle
citreum -i=lemon
limonata -ae=lemonade
lactuca -ae=lettuce
panis -is=loaf of bread
locusta -ae=lobster
margarinum -i=margarine
macellum -i=market
# Conversational Latin Glossary Ch 14/10
pulticula ex solanis=mashed potato
caro -onis=meat
carnarium -i=meat tray
index ciborum=menu
lac lactis=milk
scriblita -ae=muffin
morum -i=mulberry
fungus -i=mushroom
sinapi -is=mustard
nux nucis=nut
oleum -i=olive oil
oliva -ae=olive
laganum ex ovis=omelet
caepa -ae=onion
malum aurantium=orange
collyria=pasta
pisum -i=pea
persicum -i=peach
arachis -idis=peanut
pirum -i=pear
piper -eris=pepper
piperinum -i=pepper shaker
salgamum -i=pickle
frustum -i=piece
crustum -i=pie
urceus -i=pitcher
patella -ae=plate
prunum -i=plum
porcina -ae=pork
offa porcina=pork chop
pomum terrestre=potato
laminae pomorum terrestrium=potato chips
semicoctus -a -um=rare [opp: percoctus]
oryza -ae=rice
assum -i=roast
assare=to roast
paniculus -i=roll
sal salis=salt
pastillum fartum=sandwich
sarda -ae=sardine
ius iuris=sauce
farcimen -inis=sausage
condimentum -i=seasoning
appono -ere apposui appositus=serve (food)
putamen -inis=shell
squilla -ae=shrimp (prawn)
argentea -orum=silverware
sorbillare=to sip
segmentum -i=slice
cochlear -aris=spoon
frustum bubulae=steak
iurulentum -i=stew
focus -i=stove
sipho -onis=straw (for drinking)
fragum -i=strawberry
saccharum -i=sugar
sapio -ere -ivi=to taste
thea -ae=tea
corollarium -i, stips stipis=tip
panis tostus=toast
lycopersicum -i=tomato
ferculum -i=tray
holus -eris=vegetable
acetum -i=vinegar
melopepo -onis=watermelon
vinum=wine [dry: austerum; sweet: dulce; red: sanguineum; light: tenue; white: album]
# Conversational Latin Glossary Ch 15/10
adultus -a -um=adult
aetas -atis=age
longaevus -a -um=aged
aetate prevectus esse=be up in years
nativitas -atis=birth
nascor natus sum=to be born
pueritia -ae; aetas puerilis=boyhood
a puero=from boyhood on
fasti -orum, calendarium -i=calendar
saeculum -i=century
mors -tis=death
morior -i mortuus sum=die
senesco -ere senui=grow old
iuvenesco -ere iuveni=grow up
adulescens -entis=gowing up
infantia -ae=infancy
mensis -is=month
Ianuarius -i=January
Februarius -i=February
Martius -i=March
Aprilius -i=April
Maius -i=May
Iunius -i=June
Iulius -i=July
Augustus -i=August
September -bris=September
October -bris=October
November -bris=November
December -bris=December
maior (minor) quam ... annos natus=more (less) than ... years old
vetulus -a -um=old
... annos natus -a -um esse=to be ... years old
senectus -utis, senecta -ae=old age
senex -s=old man
anus -us=old woman
aetas vitae=period of life
tempus anni=season
ver veris=Spring
aestas -atis=summer
autumnus -i=autumn (fall)
hiems -emis=winter
dies Lunae=Monday
dies Martis=Tuesday
dies Mercurii=Wednesday
dies Iovis=Thursday
dies Veneris=Friday
dies Saturni, Sabbata -orum=Saturday
Dies Solis, dominica -ae=Sunday
annus -i=year
parvus -a -um, parvulus -a -um=young
adulescentulus/a -i/-ae=youngster
adulescentia -ae=youth (between puer and iuvenis- 15 and 30)
iuvenilis -is -e=youthful
# Conversational Latin Glossary Ch 16/10
abhinc=ago
paulo ante=a short while ago
quam pridem?=how long ago?
iamdudum, iampridem=long ago
haud ita pridem=not so long ago
pridem dudum=sometime ago
postquam, post (+indic.)=after
tempus postmeridianum=afternoon
postmeridie, post meridiem=in the afternoon
posthac=afterwards
etiam atque etiam, identidem=again and again
semper=always
circa, circiter (+acc), de (+abl)=around
quamdiu=as long as
quam primum=as soon as possible
adhuc=as yet
utique=at least
summum=at most
continuo, momento=at once
antequam, priusquam, antea, ante (+acc)=before
propediem=before long
antehac=before now
summatim=briefly
ad (+acc)=by (no later than)
horologium -i=clock
de nocte=after dark, in the dark
tenebrae -arum=darkness
quam ad diem?=by what date?
propediem=any day now
interdiu=by day
cotidie, in singulos dies=every day
in dies=from day to day
ex eo die=from that day on
quodam die=one day (a certain day in the past)
pridie=on the previous day
postero die=on the following day
perendie=the day after tomorrow
ad multum diem=until late in the day
his temporibus=these days
at dawn=prima luce
anteluculo=before dawn
diluculo=at daybreak
in primam lucem, usque diluculum=till daybreak
inter (+acc)=during
ab extremo=in the end
vesper -eri, vespera -ae=evening
umquam=ever
ad extremum, tandem=finally
primo=first
primum=first (in a series followed by deinde, postremo)
initio=at first
primum omnium=first of all
futura -orum=future
in posterum=in the future
semihora -ae, dimidium -i horae=half hour
posthac=hereafter
depraesentiarum=here and now
hora -ae=hour
sesquihora -ae=an hour and a half
in horas=hourly
quam diu?=how long?
quam pridem?=how long ago?
quotiens?=how often?
quam mox?=how soon?
statim, continuo=immediately
modo=just
cum modo=just as
sub (+acc)=just before
tempori=just in time
tunc maxime=just then
novissimus -a -um=last (adv)
serus -a -um=late
nuper=lastly
differo in aliud tempus=to postpone until later
saltem=at least
diu=long
quam diu=how long
quamdiu etiam=how much longer
interim=meanwhile
media nox=midnight
minuta -ae=minute
momento temporis=In a minute
extemplo ubi ego te vidi=the minute I saw you
iam=this minutes
expecta paulum, mane dum, mane paulisper=wait a minute
tempus matutinum=morning
bene mane, multo mane=early in the morning
a mane usque ad vesperam=from morning till evening
mane=in the morning
in ipso articulo temporis=in the nick of time
# Conversational Latin Glossary Ch 17/10
nox noctis=night
sub noctem=just before nightfall
usque ad noctem=till nightfall
numquam=never
nondum=never yet
non diutius=no longer
meridies ei=noon
nondum=not yet
nunc. iam=now
iam nunc=even now
subinde, nonnumquam, aliquando=now and then
nunc tandem=now at last
modo...modo=now...now
posteaquam=not that
hodie=nowadays
in tempus=for the occasion
subinde=occasionally
quodam die=once (on a certain occasion)
semel=once (one time)
ilico, statim=at once
olim=once upon a time
semel atque iterum=once or twice
antehac=in the past
hoc loco=at this point (in time)
prius=previously
raro=rarely
in principio ilico=right from the start
ut=since (temporal)
aliquando, aliqua die=someday
serius ocius, serius aut citius=sooner or later
tum=then (at that time)
deinde=then (next)
crepusculum -i=twilight
donec=until
cum, ubi, ut; quando (interrog.)=when
quandocumque, utcumque, quotiens=whenever
dum=while
tempus fallo=to while away the time
quotannis=every year
ineunte anno, principio anni=at the beginning of the year
exeunte anno=at the end of the year
heri=yesterday
nudius tertius=the day before yesterday
tempus fuit cum...=there was a time when
tempus perdere=to waste time
tempus maxime est ut tu (+subj)=it is high time for you to...